"filename", "language", "C#", "comment", "blank", "total"
"d:\Unity\Unity Projects\Enter_The_Dungeon\Assets\_Main\Scripts\Ability System\Ability - System\Authoring\AbilityTags.cs", "C#", 16, 24, 9, 49
"d:\Unity\Unity Projects\Enter_The_Dungeon\Assets\_Main\Scripts\Ability System\Ability - System\Authoring\AbstractAbilityScriptableObject.cs", "C#", 14, 23, 7, 44
"d:\Unity\Unity Projects\Enter_The_Dungeon\Assets\_Main\Scripts\Ability System\Ability - System\Authoring\AbstractAbilitySpec.cs", "C#", 149, 36, 35, 220
"d:\Unity\Unity Projects\Enter_The_Dungeon\Assets\_Main\Scripts\Ability System\Ability - System\Authoring\HitAbilityScriptableObject.cs", "C#", 112, 0, 17, 129
"d:\Unity\Unity Projects\Enter_The_Dungeon\Assets\_Main\Scripts\Ability System\Ability - System\Authoring\InitialiseStatsAbilityScriptableObject.cs", "C#", 58, 1, 12, 71
"d:\Unity\Unity Projects\Enter_The_Dungeon\Assets\_Main\Scripts\Ability System\Ability - System\Authoring\Melee Ability\AbstractMeleeAttackAbilityScriptableObject.cs", "C#", 90, 0, 18, 108
"d:\Unity\Unity Projects\Enter_The_Dungeon\Assets\_Main\Scripts\Ability System\Ability - System\Authoring\Melee Ability\CapsuleMeleeAttackAbilityScriptableObject.cs", "C#", 40, 0, 9, 49
"d:\Unity\Unity Projects\Enter_The_Dungeon\Assets\_Main\Scripts\Ability System\Ability - System\Authoring\Melee Ability\SphereMeleeAttackAbilityScriptableObject.cs", "C#", 31, 0, 6, 37
"d:\Unity\Unity Projects\Enter_The_Dungeon\Assets\_Main\Scripts\Ability System\Ability - System\Authoring\Range Ability\AbstractRangeCastAbilityScriptableObject.cs", "C#", 86, 0, 18, 104
"d:\Unity\Unity Projects\Enter_The_Dungeon\Assets\_Main\Scripts\Ability System\Ability - System\Authoring\Range Ability\CapsuleCastAbilityScriptableObject.cs", "C#", 79, 0, 16, 95
"d:\Unity\Unity Projects\Enter_The_Dungeon\Assets\_Main\Scripts\Ability System\Ability - System\Authoring\Range Ability\ConeCastAbilityScriptableObject.cs", "C#", 83, 0, 14, 97
"d:\Unity\Unity Projects\Enter_The_Dungeon\Assets\_Main\Scripts\Ability System\Ability - System\Authoring\Range Ability\SectorCastAbilityScriptableObject.cs", "C#", 84, 0, 15, 99
"d:\Unity\Unity Projects\Enter_The_Dungeon\Assets\_Main\Scripts\Ability System\Ability - System\Authoring\Range Ability\SphereCastAbilityScriptableObject.cs", "C#", 74, 0, 15, 89
"d:\Unity\Unity Projects\Enter_The_Dungeon\Assets\_Main\Scripts\Ability System\Ability - System\Authoring\SimpleAbilityScriptableObject.cs", "C#", 48, 39, 12, 99
"d:\Unity\Unity Projects\Enter_The_Dungeon\Assets\_Main\Scripts\Ability System\Ability - System\Authoring\Spawn Ability\DeathSpawnAbilityScriptableObject.cs", "C#", 12, 2, 5, 19
"d:\Unity\Unity Projects\Enter_The_Dungeon\Assets\_Main\Scripts\Ability System\Ability - System\Authoring\Spawn Ability\ProjectileSpawnAbilityScriptableObject.cs", "C#", 128, 0, 19, 147
"d:\Unity\Unity Projects\Enter_The_Dungeon\Assets\_Main\Scripts\Ability System\Ability - System\Component\AbilitySystemController.cs", "C#", 216, 2, 38, 256
"d:\Unity\Unity Projects\Enter_The_Dungeon\Assets\_Main\Scripts\Ability System\Ability - System\Event\AbstractApplyGameplayEffectEventHandler.cs", "C#", 9, 0, 6, 15
"d:\Unity\Unity Projects\Enter_The_Dungeon\Assets\_Main\Scripts\Ability System\Ability - System\Event\LogApplyGameplayEffectEventHandler.cs", "C#", 16, 0, 2, 18
"d:\Unity\Unity Projects\Enter_The_Dungeon\Assets\_Main\Scripts\Ability System\Ability - System\Event\NotifyGameplayEffectEventHandler.cs", "C#", 20, 0, 3, 23
"d:\Unity\Unity Projects\Enter_The_Dungeon\Assets\_Main\Scripts\Ability System\Ability - System\Event\PlayParticleGameplayEffectEventHandler.cs", "C#", 12, 2, 5, 19
"d:\Unity\Unity Projects\Enter_The_Dungeon\Assets\_Main\Scripts\Ability System\Ability - System\Event\ShowPopupGameplayEffectEventHandler.cs", "C#", 88, 0, 21, 109
"d:\Unity\Unity Projects\Enter_The_Dungeon\Assets\_Main\Scripts\Ability System\Ability - System\ModifierMagnitude\AttributeBackedModifierMagnitude.cs", "C#", 43, 0, 11, 54
"d:\Unity\Unity Projects\Enter_The_Dungeon\Assets\_Main\Scripts\Ability System\Ability - System\ModifierMagnitude\ECaptureAttributeFrom.cs", "C#", 7, 0, 1, 8
"d:\Unity\Unity Projects\Enter_The_Dungeon\Assets\_Main\Scripts\Ability System\Ability - System\ModifierMagnitude\ECaptureAttributeWhen.cs", "C#", 7, 0, 1, 8
"d:\Unity\Unity Projects\Enter_The_Dungeon\Assets\_Main\Scripts\Ability System\Ability - System\ModifierMagnitude\ModifierMagnitudeScriptableObject.cs", "C#", 9, 9, 3, 21
"d:\Unity\Unity Projects\Enter_The_Dungeon\Assets\_Main\Scripts\Ability System\Ability - System\ModifierMagnitude\SimpleFloatModifierMagnitude.cs", "C#", 18, 0, 3, 21
"d:\Unity\Unity Projects\Enter_The_Dungeon\Assets\_Main\Scripts\Ability System\Attributes - System\AttributeScriptableObject.cs", "C#", 24, 6, 5, 35
"d:\Unity\Unity Projects\Enter_The_Dungeon\Assets\_Main\Scripts\Ability System\Attributes - System\AttributeSystemComponent.cs", "C#", 156, 12, 34, 202
"d:\Unity\Unity Projects\Enter_The_Dungeon\Assets\_Main\Scripts\Ability System\Attributes - System\AttributeValue.cs", "C#", 26, 0, 3, 29
"d:\Unity\Unity Projects\Enter_The_Dungeon\Assets\_Main\Scripts\Ability System\Attributes - System\EAttributeModifierType.cs", "C#", 9, 0, 2, 11
"d:\Unity\Unity Projects\Enter_The_Dungeon\Assets\_Main\Scripts\Ability System\Attributes - System\EquipmentAttributeBuilder.cs", "C#", 25, 0, 7, 32
"d:\Unity\Unity Projects\Enter_The_Dungeon\Assets\_Main\Scripts\Ability System\Attributes - System\Event\AbstractAttributeEventHandler.cs", "C#", 21, 0, 4, 25
"d:\Unity\Unity Projects\Enter_The_Dungeon\Assets\_Main\Scripts\Ability System\Attributes - System\Event\ClampAttributeEventHandler.cs", "C#", 37, 1, 10, 48
"d:\Unity\Unity Projects\Enter_The_Dungeon\Assets\_Main\Scripts\Ability System\Attributes - System\Event\LogAttributeChangeEventHandler.cs", "C#", 27, 1, 9, 37
"d:\Unity\Unity Projects\Enter_The_Dungeon\Assets\_Main\Scripts\Ability System\Attributes - System\Event\NotifyAttributeChangeEventHandler.cs", "C#", 54, 0, 12, 66
"d:\Unity\Unity Projects\Enter_The_Dungeon\Assets\_Main\Scripts\Ability System\Attributes - System\Event\ShowValueChangesEventHandler.cs", "C#", 83, 0, 18, 101
"d:\Unity\Unity Projects\Enter_The_Dungeon\Assets\_Main\Scripts\Ability System\Attributes - System\LinearDerivedAttributeScriptableObject.cs", "C#", 23, 0, 7, 30
"d:\Unity\Unity Projects\Enter_The_Dungeon\Assets\_Main\Scripts\Ability System\Effect - System\ConditionalGameplayEffectContainer.cs", "C#", 10, 0, 3, 13
"d:\Unity\Unity Projects\Enter_The_Dungeon\Assets\_Main\Scripts\Ability System\Effect - System\EDurationPolicy.cs", "C#", 9, 0, 2, 11
"d:\Unity\Unity Projects\Enter_The_Dungeon\Assets\_Main\Scripts\Ability System\Effect - System\GameplayEffectDefinitionContainer.cs", "C#", 14, 12, 7, 33
"d:\Unity\Unity Projects\Enter_The_Dungeon\Assets\_Main\Scripts\Ability System\Effect - System\GameplayEffectModifier.cs", "C#", 18, 0, 3, 21
"d:\Unity\Unity Projects\Enter_The_Dungeon\Assets\_Main\Scripts\Ability System\Effect - System\GameplayEffectPeriod.cs", "C#", 10, 9, 4, 23
"d:\Unity\Unity Projects\Enter_The_Dungeon\Assets\_Main\Scripts\Ability System\Effect - System\GameplayEffectScriptableObject.cs", "C#", 14, 0, 5, 19
"d:\Unity\Unity Projects\Enter_The_Dungeon\Assets\_Main\Scripts\Ability System\Effect - System\GameplayEffectSpec.cs", "C#", 85, 2, 15, 102
"d:\Unity\Unity Projects\Enter_The_Dungeon\Assets\_Main\Scripts\Ability System\Effect - System\GameplayEffectTags.cs", "C#", 14, 15, 6, 35
"d:\Unity\Unity Projects\Enter_The_Dungeon\Assets\_Main\Scripts\Ability System\Effect - System\GameplayTagRequireIgnoreContainer.cs", "C#", 10, 6, 4, 20
"d:\Unity\Unity Projects\Enter_The_Dungeon\Assets\_Main\Scripts\Ability System\Equipment - System\AbstractEquipmentEffectBuilder.cs", "C#", 9, 0, 4, 13
"d:\Unity\Unity Projects\Enter_The_Dungeon\Assets\_Main\Scripts\Ability System\Equipment - System\EquipmentEffect.cs", "C#", 22, 0, 2, 24
"d:\Unity\Unity Projects\Enter_The_Dungeon\Assets\_Main\Scripts\Ability System\Equipment - System\EquipmentRandomEffectBuilder.cs", "C#", 23, 0, 5, 28
"d:\Unity\Unity Projects\Enter_The_Dungeon\Assets\_Main\Scripts\Ability System\Gameplay - Tags\GameplayTagScriptableObject.cs", "C#", 23, 11, 8, 42
"d:\Unity\Unity Projects\Enter_The_Dungeon\Assets\_Main\Scripts\Character System\Config\ImpactConfig.cs", "C#", 9, 0, 3, 12
"d:\Unity\Unity Projects\Enter_The_Dungeon\Assets\_Main\Scripts\Character System\Config\MotorConfig.cs", "C#", 70, 5, 13, 88
"d:\Unity\Unity Projects\Enter_The_Dungeon\Assets\_Main\Scripts\Character System\Config\TargetingConfig.cs", "C#", 14, 0, 8, 22
"d:\Unity\Unity Projects\Enter_The_Dungeon\Assets\_Main\Scripts\Character System\Config\VisionConfig.cs", "C#", 16, 0, 9, 25
"d:\Unity\Unity Projects\Enter_The_Dungeon\Assets\_Main\Scripts\Character System\Input System\PlayerControls.cs", "C#", 359, 12, 19, 390
"d:\Unity\Unity Projects\Enter_The_Dungeon\Assets\_Main\Scripts\Character System\Models\BaseAgent.cs", "C#", 268, 18, 65, 351
"d:\Unity\Unity Projects\Enter_The_Dungeon\Assets\_Main\Scripts\Character System\Models\BatAgent.cs", "C#", 12, 0, 5, 17
"d:\Unity\Unity Projects\Enter_The_Dungeon\Assets\_Main\Scripts\Character System\Models\DummyAgent.cs", "C#", 7, 12, 16, 35
"d:\Unity\Unity Projects\Enter_The_Dungeon\Assets\_Main\Scripts\Character System\Models\EnemyAgent.cs", "C#", 108, 7, 29, 144
"d:\Unity\Unity Projects\Enter_The_Dungeon\Assets\_Main\Scripts\Character System\Models\GhostAgent.cs", "C#", 58, 0, 12, 70
"d:\Unity\Unity Projects\Enter_The_Dungeon\Assets\_Main\Scripts\Character System\Models\PlayerAgent.cs", "C#", 163, 13, 45, 221
"d:\Unity\Unity Projects\Enter_The_Dungeon\Assets\_Main\Scripts\Character System\Models\ZombieEliteAgent.cs", "C#", 6, 0, 3, 9
"d:\Unity\Unity Projects\Enter_The_Dungeon\Assets\_Main\Scripts\Character System\Modules\Ai Animation Events Controller\AnimatorEventsListener.cs", "C#", 38, 12, 20, 70
"d:\Unity\Unity Projects\Enter_The_Dungeon\Assets\_Main\Scripts\Character System\Modules\Ai Animation Events Controller\AnimatorEventsListenerWithRootMotion.cs", "C#", 30, 3, 7, 40
"d:\Unity\Unity Projects\Enter_The_Dungeon\Assets\_Main\Scripts\Character System\Modules\Ai Animation Events Controller\IAnimatorMoveReceiver.cs", "C#", 8, 9, 2, 19
"d:\Unity\Unity Projects\Enter_The_Dungeon\Assets\_Main\Scripts\Character System\Modules\Ai Animation Events Controller\ICharacterActionTrigger.cs", "C#", 26, 6, 11, 43
"d:\Unity\Unity Projects\Enter_The_Dungeon\Assets\_Main\Scripts\Character System\Modules\Ai Animator Controller\AgentAnimator.cs", "C#", 168, 0, 39, 207
"d:\Unity\Unity Projects\Enter_The_Dungeon\Assets\_Main\Scripts\Character System\Modules\Ai Animator Controller\EnemyAnimator.cs", "C#", 6, 0, 1, 7
"d:\Unity\Unity Projects\Enter_The_Dungeon\Assets\_Main\Scripts\Character System\Modules\Ai Animator Controller\GhostAnimatorController.cs", "C#", 38, 2, 16, 56
"d:\Unity\Unity Projects\Enter_The_Dungeon\Assets\_Main\Scripts\Character System\Modules\Ai Animator Controller\PlayerAnimatorController.cs", "C#", 31, 12, 20, 63
"d:\Unity\Unity Projects\Enter_The_Dungeon\Assets\_Main\Scripts\Character System\Modules\Ai Animator Controller\ZombieAnimatorController.cs", "C#", 18, 12, 20, 50
"d:\Unity\Unity Projects\Enter_The_Dungeon\Assets\_Main\Scripts\Character System\Modules\Ai Motor Controller\AiBasicLocomotionController.cs", "C#", 71, 14, 23, 108
"d:\Unity\Unity Projects\Enter_The_Dungeon\Assets\_Main\Scripts\Character System\Modules\Ai Motor Controller\AiMotorController.cs", "C#", 81, 13, 29, 123
"d:\Unity\Unity Projects\Enter_The_Dungeon\Assets\_Main\Scripts\Character System\Modules\Ai Motor Controller\AiRollController.cs", "C#", 58, 12, 22, 92
"d:\Unity\Unity Projects\Enter_The_Dungeon\Assets\_Main\Scripts\Character System\Modules\Ai Motor Controller\ICombatController.cs", "C#", 52, 0, 27, 79
"d:\Unity\Unity Projects\Enter_The_Dungeon\Assets\_Main\Scripts\Character System\Modules\Ai Motor Controller\ILocomotionController.cs", "C#", 11, 0, 2, 13
"d:\Unity\Unity Projects\Enter_The_Dungeon\Assets\_Main\Scripts\Character System\Modules\Ai Motor Controller\MeleeCombatController.cs", "C#", 97, 12, 25, 134
"d:\Unity\Unity Projects\Enter_The_Dungeon\Assets\_Main\Scripts\Character System\Modules\Ai Motor Controller\RangedCombatController.cs", "C#", 83, 12, 29, 124
"d:\Unity\Unity Projects\Enter_The_Dungeon\Assets\_Main\Scripts\Character System\Modules\Ai Targeting Agent Controller\AITargetingPickUpController.cs", "C#", 10, 2, 5, 17
"d:\Unity\Unity Projects\Enter_The_Dungeon\Assets\_Main\Scripts\Character System\Modules\Ai Targeting Agent Controller\BaseTargetingAgentController.cs", "C#", 87, 15, 30, 132
"d:\Unity\Unity Projects\Enter_The_Dungeon\Assets\_Main\Scripts\Character System\Modules\Ai Targeting Agent Controller\ITargetingController.cs", "C#", 10, 0, 5, 15
"d:\Unity\Unity Projects\Enter_The_Dungeon\Assets\_Main\Scripts\Character System\Modules\Ai Targeting Agent Controller\PlayerTargetingAgentController.cs", "C#", 17, 5, 6, 28
"d:\Unity\Unity Projects\Enter_The_Dungeon\Assets\_Main\Scripts\Character System\Modules\Ai Vision Controller\AiImpactSensorController.cs", "C#", 58, 12, 22, 92
"d:\Unity\Unity Projects\Enter_The_Dungeon\Assets\_Main\Scripts\Character System\Modules\Ai Vision Controller\AiVisionSensorController.cs", "C#", 100, 15, 30, 145
"d:\Unity\Unity Projects\Enter_The_Dungeon\Assets\_Main\Scripts\Character System\Modules\Ai Vision Controller\ISensorController.cs", "C#", 10, 0, 2, 12
"d:\Unity\Unity Projects\Enter_The_Dungeon\Assets\_Main\Scripts\Character System\Modules\Ai Weapon Visual\AiWeaponVisualsController.cs", "C#", 88, 13, 25, 126
"d:\Unity\Unity Projects\Enter_The_Dungeon\Assets\_Main\Scripts\Character System\Modules\Ai Weapon Visual\PlayerWeaponVisualController.cs", "C#", 7, 12, 18, 37
"d:\Unity\Unity Projects\Enter_The_Dungeon\Assets\_Main\Scripts\Character System\Modules\Shared\AiAbilityController.cs", "C#", 56, 12, 15, 83
"d:\Unity\Unity Projects\Enter_The_Dungeon\Assets\_Main\Scripts\Character System\Modules\Shared\AiBodyPart.cs", "C#", 32, 0, 11, 43
"d:\Unity\Unity Projects\Enter_The_Dungeon\Assets\_Main\Scripts\Character System\Modules\Shared\AiMemoryController.cs", "C#", 49, 15, 19, 83
"d:\Unity\Unity Projects\Enter_The_Dungeon\Assets\_Main\Scripts\Character System\Modules\Shared\AiMemoryObject.cs", "C#", 17, 5, 4, 26
"d:\Unity\Unity Projects\Enter_The_Dungeon\Assets\_Main\Scripts\Character System\Modules\Shared\BodyPartType.cs", "C#", 7, 0, 1, 8
"d:\Unity\Unity Projects\Enter_The_Dungeon\Assets\_Main\Scripts\Character System\Modules\Shared\LockPivot.cs", "C#", 7, 0, 2, 9
"d:\Unity\Unity Projects\Enter_The_Dungeon\Assets\_Main\Scripts\Character System\Modules\Shared\SimpleDeadBody.cs", "C#", 70, 2, 17, 89
"d:\Unity\Unity Projects\Enter_The_Dungeon\Assets\_Main\Scripts\ClassTemplate.cs", "C#", 6, 12, 18, 36
"d:\Unity\Unity Projects\Enter_The_Dungeon\Assets\_Main\Scripts\Context System\AuthContext.cs", "C#", 71, 4, 8, 83
"d:\Unity\Unity Projects\Enter_The_Dungeon\Assets\_Main\Scripts\Core\AtomicExtension.cs", "C#", 462, 47, 68, 577
"d:\Unity\Unity Projects\Enter_The_Dungeon\Assets\_Main\Scripts\Core\BaseSO.cs", "C#", 20, 0, 6, 26
"d:\Unity\Unity Projects\Enter_The_Dungeon\Assets\_Main\Scripts\Core\CoroutineUtils.cs", "C#", 35, 15, 6, 56
"d:\Unity\Unity Projects\Enter_The_Dungeon\Assets\_Main\Scripts\Core\IInitializable.cs", "C#", 12, 5, 1, 18
"d:\Unity\Unity Projects\Enter_The_Dungeon\Assets\_Main\Scripts\Core\IInitializableWithBaseModel.cs", "C#", 10, 2, 2, 14
"d:\Unity\Unity Projects\Enter_The_Dungeon\Assets\_Main\Scripts\Core\MinMaxParameters.cs", "C#", 35, 0, 6, 41
"d:\Unity\Unity Projects\Enter_The_Dungeon\Assets\_Main\Scripts\Core\ProjectileMotionExtension.cs", "C#", 38, 0, 10, 48
"d:\Unity\Unity Projects\Enter_The_Dungeon\Assets\_Main\Scripts\Core\RemoveMissingScriptsEditor.cs", "C#", 61, 0, 14, 75
"d:\Unity\Unity Projects\Enter_The_Dungeon\Assets\_Main\Scripts\Core\ScriptableObjectManager.cs", "C#", 47, 0, 6, 53
"d:\Unity\Unity Projects\Enter_The_Dungeon\Assets\_Main\Scripts\Projectile System\ProjectileBase.cs", "C#", 66, 16, 18, 100
"d:\Unity\Unity Projects\Enter_The_Dungeon\Assets\_Main\Scripts\Projectile System\ProjectileCannon.cs", "C#", 54, 6, 14, 74
"d:\Unity\Unity Projects\Enter_The_Dungeon\Assets\_Main\Scripts\Projectile System\ProjectileFollowTarget.cs", "C#", 71, 6, 20, 97
"d:\Unity\Unity Projects\Enter_The_Dungeon\Assets\_Main\Scripts\Projectile System\ProjectileStandard.cs", "C#", 39, 12, 15, 66
"d:\Unity\Unity Projects\Enter_The_Dungeon\Assets\_Main\Scripts\UI System\Auth\LoginForm.cs", "C#", 113, 9, 16, 138
"d:\Unity\Unity Projects\Enter_The_Dungeon\Assets\_Main\Scripts\UI System\Auth\RecoveryForm.cs", "C#", 70, 4, 9, 83
"d:\Unity\Unity Projects\Enter_The_Dungeon\Assets\_Main\Scripts\UI System\Auth\RegistrationForm.cs", "C#", 116, 4, 16, 136
"d:\Unity\Unity Projects\Enter_The_Dungeon\Assets\_Main\Scripts\UI System\Currency\ClanCurrencyPanel.cs", "C#", 70, 1, 10, 81
"d:\Unity\Unity Projects\Enter_The_Dungeon\Assets\_Main\Scripts\UI System\Currency\CurrencyItem.cs", "C#", 61, 2, 9, 72
"d:\Unity\Unity Projects\Enter_The_Dungeon\Assets\_Main\Scripts\UI System\Currency\CurrencyPackItem.cs", "C#", 68, 1, 13, 82
"d:\Unity\Unity Projects\Enter_The_Dungeon\Assets\_Main\Scripts\UI System\Currency\CurrencyPanel.cs", "C#", 73, 2, 12, 87
"d:\Unity\Unity Projects\Enter_The_Dungeon\Assets\_Main\Scripts\UI System\Currency\CurrencyRechargeTimer.cs", "C#", 53, 1, 7, 61
"d:\Unity\Unity Projects\Enter_The_Dungeon\Assets\_Main\Scripts\UI System\Currency\CurrencyShop.cs", "C#", 67, 1, 11, 79
"d:\Unity\Unity Projects\Enter_The_Dungeon\Assets\_Main\Scripts\UI System\Currency\CurrencyShopTab.cs", "C#", 29, 0, 4, 33
"d:\Unity\Unity Projects\Enter_The_Dungeon\Assets\_Main\Scripts\UI System\Currency\CurrencySlot.cs", "C#", 36, 1, 6, 43
"d:\Unity\Unity Projects\Enter_The_Dungeon\Assets\_Main\Scripts\UI System\EffectPopupAnimation.cs", "C#", 123, 12, 33, 168
"d:\Unity\Unity Projects\Enter_The_Dungeon\Assets\_Main\Scripts\UI System\Equipment Store\SpecialOfferFrame.cs", "C#", 71, 1, 9, 81
"d:\Unity\Unity Projects\Enter_The_Dungeon\Assets\_Main\Scripts\UI System\Equipment Store\SpecialOfferFrameLoader.cs", "C#", 110, 1, 16, 127
"d:\Unity\Unity Projects\Enter_The_Dungeon\Assets\_Main\Scripts\UI System\Equipment Store\SpecialOfferWindow.cs", "C#", 113, 3, 13, 129
"d:\Unity\Unity Projects\Enter_The_Dungeon\Assets\_Main\Scripts\UI System\Equipment Store\StoreContentScroller.cs", "C#", 9, 0, 2, 11
"d:\Unity\Unity Projects\Enter_The_Dungeon\Assets\_Main\Scripts\UI System\Equipment Store\StoreItem.cs", "C#", 187, 2, 20, 209
"d:\Unity\Unity Projects\Enter_The_Dungeon\Assets\_Main\Scripts\UI System\Equipment Store\StoreLoad.cs", "C#", 8, 0, 2, 10
"d:\Unity\Unity Projects\Enter_The_Dungeon\Assets\_Main\Scripts\UI System\Equipment Store\StorePurchaseButton.cs", "C#", 40, 0, 6, 46
"d:\Unity\Unity Projects\Enter_The_Dungeon\Assets\_Main\Scripts\UI System\Equipment Store\StoreTitle.cs", "C#", 74, 1, 13, 88
"d:\Unity\Unity Projects\Enter_The_Dungeon\Assets\_Main\Scripts\UI System\Equipment Store\StoreTitleScroller.cs", "C#", 9, 0, 2, 11
"d:\Unity\Unity Projects\Enter_The_Dungeon\Assets\_Main\Scripts\UI System\Equipment Store\StoreWindow.cs", "C#", 123, 2, 14, 139
"d:\Unity\Unity Projects\Enter_The_Dungeon\Assets\_Main\Scripts\UI System\Inventory\CategoryTab.cs", "C#", 6, 0, 2, 8
"d:\Unity\Unity Projects\Enter_The_Dungeon\Assets\_Main\Scripts\UI System\Inventory\DraggableInventorySlot.cs", "C#", 68, 0, 10, 78
"d:\Unity\Unity Projects\Enter_The_Dungeon\Assets\_Main\Scripts\UI System\Inventory\Equipments.cs", "C#", 70, 1, 12, 83
"d:\Unity\Unity Projects\Enter_The_Dungeon\Assets\_Main\Scripts\UI System\Inventory\Inventory.cs", "C#", 168, 6, 25, 199
"d:\Unity\Unity Projects\Enter_The_Dungeon\Assets\_Main\Scripts\UI System\Inventory\InventoryItemInfo.cs", "C#", 186, 2, 24, 212
"d:\Unity\Unity Projects\Enter_The_Dungeon\Assets\_Main\Scripts\UI System\Inventory\InventorySlot.cs", "C#", 52, 2, 10, 64
"d:\Unity\Unity Projects\Enter_The_Dungeon\Assets\_Main\Scripts\UI System\Inventory\RecipeInventory.cs", "C#", 57, 3, 11, 71
"d:\Unity\Unity Projects\Enter_The_Dungeon\Assets\_Main\Scripts\UI System\Stage Select\StageItem.cs", "C#", 27, 0, 3, 30
"d:\Unity\Unity Projects\Enter_The_Dungeon\Assets\_Main\Scripts\UI System\Stage Select\StageWindow.cs", "C#", 12, 2, 5, 19
"d:\Unity\Unity Projects\Enter_The_Dungeon\Assets\_Main\Scripts\Weapon System\KeepFollow.cs", "C#", 25, 0, 7, 32
"d:\Unity\Unity Projects\Enter_The_Dungeon\Assets\_Main\Scripts\Weapon System\WeaponType.cs", "C#", 19, 4, 1, 24
"d:\Unity\Unity Projects\Enter_The_Dungeon\Assets\_Main\Scripts\Weapon System\Weapon\IEnergyConsumer.cs", "C#", 36, 0, 10, 46
"d:\Unity\Unity Projects\Enter_The_Dungeon\Assets\_Main\Scripts\Weapon System\Weapon\Indicator\AoEIndicator.cs", "C#", 90, 14, 22, 126
"d:\Unity\Unity Projects\Enter_The_Dungeon\Assets\_Main\Scripts\Weapon System\Weapon\Indicator\ITrajectoryIndicator.cs", "C#", 26, 0, 7, 33
"d:\Unity\Unity Projects\Enter_The_Dungeon\Assets\_Main\Scripts\Weapon System\Weapon\Indicator\StraightDirectionIndicator.cs", "C#", 65, 13, 27, 105
"d:\Unity\Unity Projects\Enter_The_Dungeon\Assets\_Main\Scripts\Weapon System\Weapon\Melee Weapon\MeleeWeaponBuilder.cs", "C#", 58, 12, 17, 87
"d:\Unity\Unity Projects\Enter_The_Dungeon\Assets\_Main\Scripts\Weapon System\Weapon\Ranged Weapon\Barrel\BarrelController.cs", "C#", 13, 0, 4, 17
"d:\Unity\Unity Projects\Enter_The_Dungeon\Assets\_Main\Scripts\Weapon System\Weapon\Ranged Weapon\Barrel\SingleBarrelController.cs", "C#", 25, 0, 2, 27
"d:\Unity\Unity Projects\Enter_The_Dungeon\Assets\_Main\Scripts\Weapon System\Weapon\Ranged Weapon\RangedWeaponBuilder.cs", "C#", 92, 0, 20, 112
"d:\Unity\Unity Projects\Enter_The_Dungeon\Assets\_Main\Scripts\Weapon System\Weapon\Ranged Weapon\SingleShotWeaponBuilder.cs", "C#", 42, 12, 21, 75
"d:\Unity\Unity Projects\Enter_The_Dungeon\Assets\_Main\Scripts\Weapon System\Weapon\WeaponBuilder.cs", "C#", 37, 0, 9, 46
"Total", "-", 8650, 751, 1936, 11337